4
*****************
*0 +++++*+++++  *
* * + + + + + * *
*++ + + + + + ++*
*+++++++++++++++*
*+++++++++++++++*
**+ * * * * * +**
*+++++++++++++++*
*+++++++++++++++*
*++ + + + + + ++*
* * + + + + + * *
* ++++++*+++++ 1*
*****************
