8
*****************
*0 + + +*+ + + 2*
* + + +   + + + *
*+ + + + + + + +*
* + + + * + + + *
*+ + + +*+ + + +*
***  *******  ***
*+ + + +*+ + + +*
* + + + * + + + *
*+ + + + + + + +*
* + + +   + + + *
*3 + + +*+ + + 1*
*****************
